gay men's writings, irish;	gay people's writings, irish
presbyterian gay men;	presbyterian gay people
male reproductive health;	reproductive health
male primary school teachers;	primary school teachers
african american gay men;	african american gay people
ballet dancing for men;	ballet dancing
cosmetics for men;	cosmetics
emotional maturity in men;	emotional maturity
hispanic american young men;	hispanic american young adults
men's underwear;	underwear
male homosexuality in literature;	homosexuality in literature
arab american men in literature;	americans in literature
male prostitutes;	prostitutes
italian american gay men;	italian american gay people
gay men's writings, south african (english);	gay people's writings, south african (english)
gay men's writings, latin american;	gay people's writings, latin american
male actors;	actors
gay men's writings;	gay people's writings
male contraceptives;	contraceptives
male cheerleaders;	cheerleaders
oral contraceptives, male;	oral contraceptives
all-male adult movie theaters;	adult movie theaters
male homosexuality;	homosexuality
male prostitution;	prostitution
middle-aged gay men;	middle-aged gay people
catholic gay men;	catholic gay people
muslim gay men;	muslim gay people
men's choral societies;	choral societies
gay men's writings, canadian;	gay people's writings, canadian
male high school teachers;	high school teachers
church work with african american men;	church work with african americans
male feminists;	feminists
climacteric, male;	climacteric
deaf gay men;	deaf gay people
interpersonal communication in men;	interpersonal communication
minority gay men;	minority gay people
sandwich men;	sandwiches
gay men's writings, french;	gay people's writings, french
gay men's writings, german;	gay people's writings, german
male homosexuality in art;	homosexuality in art
hispanic american gay men;	hispanic american gay people
jewish gay men;	jewish gay people
mexican american gay men;	mexican american gay people
male cross-country runners;	cross-country runners
male striptease;	striptease
male pregnancy;	pregnancy
gay men's writings, italian;	gay people's writings, italian
gay men in literature;	gay people in literature
men, white, on television;	white people on television
older gay men;	older gay people
gay men's writings, scottish;	gay people's writings, scottish
male fans;	fans
male early childhood teachers;	early childhood teachers
male junior high school athletes;	junior high school athletes
male beauty contests;	beauty contests
gay men's writings, american;	gay people's writings, american
short men;	short people
male elementary school teachers;	elementary school teachers
male sterility in plants;	sterility in plants
male rape victims;	rape victims
parents of gay men;	parents of gay people
gay men;	gay people
gingerbread men;	gingerbread
gay men in mass media;	gay people in mass media
gay men's writings, australian;	gay people's writings, australian
male rape in art;	rape in art
gay men in comics;	gay people in comics
men's shirt industry;	shirt industry
nigerian american men;	nigerian americans
male reproductive health services;	reproductive health services
male quiltmakers;	quiltmakers
men's wrist watches;	wrist watches
male homosexuality in music;	homosexuality in music
male rape in literature;	rape in literature
gay men's writings, english;	gay people's writings, english
male contraception;	contraception
male homosexuality in motion pictures;	homosexuality in motion pictures
asian american gay men;	asian american gay people
male sexual abuse victims;	sexual abuse victims
gay men, black;	gay people, black
gay men in motion pictures;	gay people in motion pictures
leopard men;	leopard
christian gay men;	christian gay people
gay men in advertising;	gay people in advertising
rickshaw men;	rickshaws
male child care workers;	child care workers
male homosexuality in the theater;	homosexuality in the theater
male rape;	rape
