eating disorders in women;	eating disorders in men;	eating disorders
women authors, russian;	male authors, russian;	authors, russian
women comedians;	male comedians;	comedians
asian american women;	asian american men;	asian americans
women caregivers;	male caregivers;	caregivers
latter day saint women;	latter day saint men;	latter day saints
learning disabled women;	learning disabled men;	learning disabled
women with mental disabilities;	men with mental disabilities;	people with mental disabilities
bahai women;	bahai men;	bahais
female friendship in motion pictures;	male friendship in motion pictures;	friendship in motion pictures
puritan women;	puritan men;	puritans
women social workers;	male social workers;	social workers
african american bisexual women;	african american bisexual men;	african american bisexual people
women musicians;	male musicians;	musicians
church group work with women;	church group work with men;	church group work
women prisoners;	male prisoners;	prisoners
women preschool teachers;	male preschool teachers;	preschool teachers
protestant women;	protestant men;	protestants
grief in women;	grief in men;	grief
african american women college students;	african american male college students;	african american college students
working class women;	working class men;	working class
women, black, in motion pictures;	men, black, in motion pictures;	black people in motion pictures
women, white, in motion pictures;	men, white, in motion pictures;	white people in motion pictures
women immigrants;	male immigrants;	immigrants
women teachers;	male teachers;	teachers
women cooks;	male cooks;	cooks
seventh-day adventist women;	seventh-day adventist men;	seventh-day adventists
women artists;	male artists;	artists
women and literature;	men and literature;	literature
women blue collar workers;	male blue collar workers;	blue collar workers
obesity in women;	obesity in men;	obesity
indian women;	indian men;	indians
married women;	married men;	married people
women athletes;	male athletes;	athletes
women white collar workers;	male white collar workers;	white collar workers
muslim women;	muslim men;	muslims
women long-distance runners;	male long-distance runners;	long-distance runners
women lawyers;	male lawyers;	lawyers
christian education of young women;	christian education of young men;	christian education of young people
preaching to women;	preaching to men;	preaching
single women in literature;	single men in literature;	single people in literature
women college athletes;	male college athletes;	college athletes
presbyterian women;	presbyterian men;	presbyterians
upper class women;	upper class men;	upper class
gullah women;	gullah men;	gullahs
navajo women weavers;	navajo male weavers;	navajo weavers
older women in art;	older men in art;	older people in art
sexual minority women;	sexual minority men;	sexual minorities
women, maasai;	men, maasai;	maasai (african people)
italian american women;	italian american men;	italian americans
arab american women;	arab american men;	arab americans
women, black;	men, black;	black people
pentecostal women;	pentecostal men;	pentecostals
transgender women;	transgender men;	transgender people
women murderers;	male murderers;	murderers
african american women teachers;	african american male teachers;	african american teachers
women rugby union football players;	male rugby union football players;	rugby union football players
pregnant women;	pregnant men;	pregnant people
loss (psychology) in women;	loss (psychology) in men;	loss (psychology)
african american women;	african american men;	african americans
older women;	older men;	older people
church work with women;	church work with men;	church work
diving for women;	diving for men;	diving
divorced women;	divorced men;	divorced people
etiquette for women;	etiquette for men;	etiquette
exercise for women;	exercise for men;	exercise
generative organs, female;	generative organs, male;	generative organs
gymnastics for women;	gymnastics for men;	gymnastics
infertility, female;	infertility, male;	infertility
female livestock;	male livestock;	livestock
female nude in art;	male nude in art;	nude in art
women;	men;	human beings
women, white;	men, white;	white people
women consumers;	male consumers;	consumers
women dancers;	male dancers;	dancers
women nurses;	male nurses;	nurses
photography of women;	photography of men;	photography
physical fitness for women;	physical fitness for men;	physical fitness
sex instruction for women;	sex instruction for men;	sex instruction
single women;	single men;	single people
young women;	young men;	young adults
middle class women;	middle class men;	middle class
women weavers;	male weavers;	weavers
female orgasm;	male orgasm;	orgasm
women authors;	male authors;	authors
women authors, english;	male authors, english;	authors, english
hispanic american women;	hispanic american men;	hispanic americans
women's dreams;	men's dreams;	dreams
feminine names;	masculine names;	names
poor women;	poor men;	poor
bisexual women;	bisexual men;	bisexual people
heterosexual women;	heterosexual men;	heterosexuals
female friendship;	male friendship;	friendship
african american women in literature;	african american men in literature;	americans in literature
women employees;	male employees;	employees
african american young women;	african american young men;	african american young adults
women college students;	male college students;	college students
sexual harassment of women;	sexual harassment of men;	sexual harassment
women dramatists;	male dramatists;	dramatists
self-perception in women;	self-perception in men;	self-perception
japanese american women;	japanese american men;	japanese americans
deaf women;	deaf men;	deaf people
women with disabilities;	men with disabilities;	people with disabilities
women's mass media;	men's mass media;	mass media
african american women in art;	african american men in art;	americans in art
women, white, in literature;	men, white, in literature;	white people in literature
motion pictures for women;	motion pictures for men;	motion pictures
korean american women;	korean american men;	korean americans
self-esteem in women;	self-esteem in men;	self-esteem
women authors, american;	male authors, american;	authors, american
african american women singers;	african american male singers;	african american singers
women singers;	male singers;	singers
body image in women;	body image in men;	body image
female juvenile delinquents;	male juvenile delinquents;	juvenile delinquents
christian women;	christian men;	christians
catholic women;	catholic men;	catholics
female friendship in literature;	male friendship in literature;	friendship in literature
motion pictures and women;	motion pictures and men;	motion pictures
cancer in women;	cancer in men;	cancer
violence in women;	violence in men;	violence
