women fishers;	fishers
women, shan;	shan (asian people)
women sport psychologists;	sport psychologists
women detectives in motion pictures;	detectives in motion pictures
women composers;	composers
shooting for women;	shooting
women pool players;	pool players
women dramatists, korean;	dramatists, korean
armenian american women;	armenian americans
women typographers;	typographers
jaina women saints;	jaina saints
women travelers in literature;	travelers in literature
women and human security;	human security
self-acceptance in women;	self-acceptance
women, barabaig;	barabaig (african people)
women oil industry workers;	oil industry workers
african american women physicians;	african american physicians
etiquette for young women;	etiquette for young adults
women art students;	art students
women authors, italian;	authors, italian
women missionaries in literature;	missionaries in literature
women and the security sector;	security sector
women, mukkuvar;	mukkuvars
women authors, african;	authors, african
women mediums;	mediums
women spies;	spies
women insurance investigators;	insurance investigators
women folklorists;	folklorists
women, shona;	shona (african people)
african american women executives;	african american executives
women tobacco workers;	tobacco workers
women household employees;	household employees
women american loyalists;	american loyalists
dalit women;	dalits
women, beti;	beti (african people)
women philanthropists;	philanthropists
women television journalists;	television journalists
women poets, polish;	poets, polish
women radio talk show hosts;	radio talk show hosts
women's encyclopedias and dictionaries, german;	encyclopedias and dictionaries, german
college sports for women;	college sports
women personnel directors;	personnel directors
women inventors;	inventors
korean american women in literature;	americans in literature
women novelists, french-canadian;	novelists, french-canadian
women computer artists;	computer artists
women anesthesiologists;	anesthesiologists
women flower arrangers;	flower arrangers
women psychotherapists;	psychotherapists
women authors, cameroonian;	authors, cameroonian
women, oirata;	oirata (indonesian people)
women authors, kenyan;	authors, kenyan
self-management (psychology) for women;	self-management (psychology)
women's periodicals, kurdish;	kurdish periodicals
women, tamil;	tamil (indic people)
women, circassian;	circassians
women's periodicals, tamil;	tamil periodicals
women's periodicals, lithuanian;	lithuanian periodicals
women, mon;	mon (southeast asian people)
women authors, ecuadorian;	authors, ecuadorian
women architectural critics;	architectural critics
women authors, french-canadian;	authors, french-canadian
women and religion;	religion
women and democracy;	democracy
women mushers;	mushers
women, shawiya;	shawiya (berber people)
african american women authors;	african american authors
older hispanic american women;	older hispanic americans
hopi women potters;	hopi potters
women and journalism;	journalism
women college teachers, black;	college teachers, black
women, warlpiri;	warlpiri (australian people)
women taxicab drivers;	taxicab drivers
women county council members;	county council members
african american women orators;	african american orators
women political scientists;	political scientists
women, kabyle;	kabyles
german american women;	german americans
african american women musicians;	african american musicians
women balloonists;	balloonists
women, kalash;	kalash (pakistani people)
women judges;	judges
women optometrists;	optometrists
african american women poets;	african american poets
women bank robbers;	bank robbers
women authors, romanian;	authors, romanian
african american women clergy;	african american clergy
women authors, tunisian;	authors, tunisian
women parolees;	parolees
tattooed women;	tattooed people
women stringed instrument players;	stringed instrument players
sport clothes for women;	sport clothes
indian women artisans;	indian artisans
women, kabiye;	kabiye (african people)
women's hats;	hats
women video game designers;	video game designers
women, ovambo;	ovambo (african people)
women, munda;	munda (indic people)
women television news anchors;	television news anchors
women music teachers;	music teachers
women martyrs;	martyrs
women authors, irish;	authors, irish
women explorers;	explorers
women, muhajir;	muhajir (pakistani people)
women, javanese;	javanese (indonesian people)
women, chuukese;	chuukese (micronesian people)
mexican american women politicians;	mexican american politicians
women air pilots in literature;	air pilots in literature
women, suri;	suri (african people)
métis women;	métis
inuit women sculptors;	inuit sculptors
women's periodicals, serbian;	serbian periodicals
sexual minority women on television;	minorities on television
women jazz musicians;	jazz musicians
women tourists;	tourists
women conservatives;	conservatives
women violinists;	violinists
football for women;	football
women orators;	orators
women, fon;	fon (african people)
women poets, peruvian;	poets, peruvian
women pioneers in literature;	pioneers in literature
indian women civic leaders;	indian civic leaders
iraqi american women;	iraqi americans
minority women lawyers;	minority lawyers
women cleaning personnel;	cleaning personnel
women marine biologists;	marine biologists
women doctoral students;	doctoral students
women designers;	designers
women's periodicals, korean;	korean periodicals
women's wit and humor;	wit and humor
women presidents in motion pictures;	presidents in motion pictures
women graphic artists;	graphic artists
women's periodicals;	periodicals
women curriculum consultants;	curriculum consultants
african american women television producers and directors;	african american television producers and directors
women rock music fans;	rock music fans
women middle east specialists;	middle east specialists
women novelists, brazilian;	novelists, brazilian
african american women physical scientists;	african american physical scientists
women hockey players;	hockey players
women loggers;	loggers
women's periodicals, czech;	czech periodicals
women real estate agents;	real estate agents
women, kikuyu;	kikuyu (african people)
women, adygei;	adygei
jewish women athletes;	jewish athletes
women's hospitals;	hospitals
minority women in mass media;	minorities in mass media
women, ibibio;	ibibio (african people)
gentile women;	gentiles
women, diola;	diola (african people)
african american women astronauts;	african american astronauts
african american women track and field athletes;	african american track and field athletes
women authors, japanese;	authors, japanese
hmong american women;	hmong americans
pueblo women potters;	pueblo potters
women judges (islamic law);	judges (islamic law)
women librettists;	librettists
women heroes in mass media;	heroes in mass media
baul women;	bauls
women authors, german;	authors, german
women, newar;	newar (nepalese people)
african american women photographers;	african american photographers
women's periodicals, italian;	italian periodicals
women, kasem;	kasem (african people)
women poets, armenian;	poets, armenian
women, tibetan;	tibetans
women superheroes in comics;	superheroes in comics
women, bemba;	bemba (african people)
women transport workers;	transport workers
women, loma;	loma (african people)
tewa women potters;	tewa potters
women, chamorro;	chamorro (micronesian people)
national socialism and women;	national socialism
women microbiologists;	microbiologists
women, dogon;	dogon (african people)
women food writers;	food writers
women violists;	violists
indian women basket makers;	indian basket makers
women abolitionists;	abolitionists
women water-skiers;	water-skiers
african american women architects;	african american architects
women medical scientists;	medical scientists
women, nyarafolo;	nyarafolo (african people)
african american women superheroes;	african american superheroes
women truck drivers;	truck drivers
women veterans;	veterans
female wolves;	wolves
women physiologists;	physiologists
self-defense for women;	self-defense
women interior decorators;	interior decorators
women, eurasian;	eurasians
women kapos;	kapos
women cricket players;	cricket players
women animators;	animators
tai chi for women;	tai chi
women hockey coaches;	hockey coaches
african american women diplomats;	african american diplomats
women egyptologists;	egyptologists
women naturalists;	naturalists
women authors, swedish;	authors, swedish
women, basque;	basques
women detectives in mass media;	detectives in mass media
muslim women superheroes;	muslim superheroes
african american women scientists;	african american scientists
sleep apnea syndromes in women;	sleep apnea syndromes
women radio broadcasters;	radio broadcasters
women, grasia;	grasia (indic people)
minority women activists;	minority activists
running for women;	running
women religious zionists;	religious zionists
softball for women;	softball
ukrainian american women;	ukrainian americans
women merchant mariners;	merchant mariners
samaritan women;	samaritans
women outlaws;	outlaws
women poets, portuguese;	poets, portuguese
aztec women;	aztecs
african american sexual minority women;	african american sexual minorities
technology and women;	technology
women, sotho;	sotho (african people)
women fire fighters;	fire fighters
women, karanga;	karanga (african people)
tall women;	tall people
indian women educators;	indian educators
women linguists;	linguists
women surgeons;	surgeons
women gamblers;	gamblers
women flute players;	flute players
women journalists in literature;	journalists in literature
women scientists;	scientists
women periodical editors;	periodical editors
women biologists;	biologists
women and animals;	animals
women authors, ukrainian;	authors, ukrainian
women, kuria;	kuria (african people)
women, bhotia;	bhotia (tibetan people)
swiss american women;	swiss americans
fencing for women;	fencing
women sugar workers;	sugar workers
women technologists;	technologists
slovenian american women;	slovenian americans
women-owned law firms;	law firms
swedish american women;	swedish americans
pakistani american women;	pakistani americans
women coffee growers;	coffee growers
women choreographers;	choreographers
women construction workers;	construction workers
women chemists;	chemists
christian women saints;	christian saints
women statisticians;	statisticians
women's encyclopedias and dictionaries;	encyclopedias and dictionaries
women, kewa;	kewa (papua new guinean people)
women authors, dutch;	authors, dutch
indian women entertainers;	indian entertainers
women electronic industry workers;	electronic industry workers
hindu women;	hindus
women authors, azerbaijani;	authors, azerbaijani
women presidents;	presidents
women hunters;	hunters
women, khmu';	khmu' (southeast asian people)
women novelists, japanese;	novelists, japanese
women and peace;	peace
women and the mafia;	mafia
women, tuareg;	tuaregs
baptist women;	baptists
architecture and women;	architecture
women authors, sindhi;	authors, sindhi
women textile designers;	textile designers
women, pygmy;	pygmies
women helicopter pilots;	helicopter pilots
african american women mathematicians;	african american mathematicians
women's periodicals, philippine;	philippine periodicals
women archivists;	archivists
jewish women philosophers;	jewish philosophers
women journalists;	journalists
women authors, new zealand;	authors, new zealand
women novelists, south african;	novelists, south african
women authors, cambodian;	authors, cambodian
women golfers;	golfers
women human rights workers;	human rights workers
women, nyishangba;	nyishangba (nepalese people)
women radicals;	radicals
women, khasi;	khasi (indic people)
female infanticide;	infanticide
women poets, pushto;	poets, pushto
women psychics;	psychics
women novelists, argentine;	novelists, argentine
women ambassadors;	ambassadors
women, gond;	gond (indic people)
christian women martyrs;	christian martyrs
women, toba-batak;	toba-batak (indonesian people)
women, murzu;	murzu (african people)
women merchants;	merchants
women amputees;	amputees
women mathematics teachers;	mathematics teachers
women swimmers;	swimmers
women authors, albanian;	authors, albanian
women epigraphists;	epigraphists
women soccer players;	soccer players
women authors, european;	authors, european
women video gamers;	video gamers
women's periodicals, french;	french periodicals
women heroes on television;	heroes on television
women poets, uzbek;	poets, uzbek
women priests;	priests
women canoeists;	canoeists
women puppeteers;	puppeteers
women scholars;	scholars
african american women cartoonists;	african american cartoonists
women athletes in art;	athletes in art
women prophets in literature;	prophets in literature
women scientists in motion pictures;	scientists in motion pictures
women poisoners;	poisoners
women millionaires;	millionaires
women, handa;	handa (african people)
women and the arts;	arts
women, talaandig;	talaandig (philippine people)
women hosiery workers;	hosiery workers
women's bookstores;	bookstores
women screenwriters;	screenwriters
women smokejumpers;	smokejumpers
women folk musicians;	folk musicians
women bluegrass musicians;	bluegrass musicians
women, yi;	yi (chinese people)
women jazz singers;	jazz singers
women poets, french;	poets, french
women athletes in literature;	athletes in literature
exiled women dancers;	exiled dancers
women, tharu;	tharu (south asian people)
women immigrants in literature;	immigrants in literature
women geneticists;	geneticists
women authors, central american;	authors, central american
museums and women;	museums
public speaking for women;	public speaking
women, nuer;	nuer (african people)
women ascetics;	ascetics
women poets, korean;	poets, korean
african american women journalists;	african american journalists
women public officers;	public officers
african american women educators;	african american educators
women life scientists;	life scientists
women, marakwet;	marakwet (african people)
women magicians;	magicians
women print dealers;	print dealers
women organists;	organists
women dramatists, scottish;	dramatists, scottish
women kindergarten teachers;	kindergarten teachers
women, hatsa;	hatsa (african people)
women's periodicals, slovenian;	slovenian periodicals
women dramatists, german;	dramatists, german
women, limbu;	limbu (south asian people)
women brewers;	brewers
yezidi women;	yezidis
women, mossi;	mossi (african people)
women soccer referees;	soccer referees
women sales personnel;	sales personnel
women poets, estonian;	poets, estonian
women industrialists;	industrialists
women authors, latin american;	authors, latin american
anxiety in women;	anxiety
women poets, slovenian;	poets, slovenian
osteoporosis in women;	osteoporosis
women fishing guides;	fishing guides
women poets, venezuelan;	poets, venezuelan
women and spiritualism;	spiritualism
women, basa;	basa (cameroonian people)
women forensic pathologists;	forensic pathologists
women poets, cuban;	poets, cuban
women psychiatrists;	psychiatrists
women, gusii;	gusii (african people)
women and anarchism;	anarchism
health education of women;	health education
navajo women shepherds;	navajo shepherds
women editors;	editors
women, iatmul;	iatmul (papua new guinean people)
women electric industry workers;	electric industry workers
women soldiers in literature;	soldiers in literature
women psychoanalysts;	psychoanalysts
cooperativeness in women;	cooperativeness
women hunting guides;	hunting guides
druze women;	druzes
women authors, afghan;	authors, afghan
women buddhist priests;	buddhist priests
women with attention-deficit hyperactivity disorder;	people with attention-deficit hyperactivity disorder
women rock musicians;	rock musicians
women heads of state;	heads of state
monasticism and religious orders for women;	monasticism and religious orders
women squash players;	squash players
women social reformers;	social reformers
women woodworkers;	woodworkers
women, bedouin;	bedouins
women heroes in art;	heroes in art
women park rangers;	park rangers
women ghostwriters;	ghostwriters
african american women fire fighters;	african american fire fighters
women, oyo;	oyo (african people)
women's periodicals, ukrainian;	ukrainian periodicals
women antiheroes;	antiheroes
women plant pathologists;	plant pathologists
women authors, polish;	authors, polish
women authors, spanish;	authors, spanish
women, kamba;	kamba (african people)
jewish women soldiers;	jewish soldiers
women bobsledders;	bobsledders
women nutritionists;	nutritionists
women horse dealers;	horse dealers
women musicians, black;	musicians, black
women, bengali;	bengali (south asian people)
women ragpickers;	ragpickers
surfing for women;	surfing
women calligraphers;	calligraphers
maya women;	mayas
indian women painters;	indian painters
self-realization in women;	self-realization
ordination of women;	ordination
african american women cooks;	african american cooks
women internment camp guards;	internment camp guards
women stunt performers;	stunt performers
women marine engineers;	marine engineers
female masturbation;	masturbation
women poets, italian;	poets, italian
women, akan;	akan (african people)
women tailors;	tailors
indian women elders (indigenous leaders);	indian elders (indigenous leaders)
female high school athletes;	high school athletes
women mathematicians;	mathematicians
women cytogeneticists;	cytogeneticists
women poets, brazilian;	poets, brazilian
women art patrons;	art patrons
filipino american women;	filipino americans
women law teachers;	law teachers
women poets, persian;	poets, persian
women, tainui;	tainui (new zealand people)
aids (disease) in women;	aids (disease)
older african american women;	older african americans
women, akha;	akha (southeast asian people)
women bridge players;	bridge players
amish women;	amish
women authors, iranian;	authors, iranian
women temporary employees;	temporary employees
women heroes in motion pictures;	heroes in motion pictures
women sociologists;	sociologists
women mammalogists;	mammalogists
women poets, american;	poets, american
women beadworkers;	beadworkers
women animal trainers;	animal trainers
women physicians in literature;	physicians in literature
women poets;	poets
women physical scientists;	physical scientists
women admirals;	admirals
women local officials and employees;	local officials and employees
female condoms;	condoms
slavic american women;	slavic americans
women college administrators;	college administrators
norwegian american women;	norwegian americans
women employees in literature;	employees in literature
female monsters in literature;	monsters in literature
women, mari;	mari (european people)
alevi women;	alevis
older women athletes;	older athletes
women economists;	economists
women authors, arab;	authors, arab
women authors, australian;	authors, australian
women, tangkhul;	tangkhul (indic people)
women composers, black;	composers, black
women, ndebele;	ndebele (african people)
women authors, french;	authors, french
indian women activists;	indian activists
discounts for women;	discount
women and war;	war
women poets, ecuadorian;	poets, ecuadorian
women authors, puerto rican;	authors, puerto rican
women, rohingya;	rohingya (burmese people)
women, black, in literature;	black people in literature
women detectives;	detectives
women dramatists, brazilian;	dramatists, brazilian
advertising and women;	advertising
women directors of corporations;	directors of corporations
rugby football for women;	rugby football
minority women college students;	minority college students
experience (religion) in women;	experience (religion)
women authors, korean;	authors, korean
women atomic bomb victims;	atomic bomb victims
women chief information officers;	chief information officers
women, mbuti;	mbuti (african people)
women college students in literature;	college students in literature
women poets, dominican;	poets, dominican
women's periodicals, swiss;	swiss periodicals
irish american women;	irish americans
women internal migrants;	internal migrants
women ship captains;	ship captains
indian women healers;	indian healers
women internment camp inmates;	internment camp inmates
women's periodicals, european;	european periodicals
women poets, arab;	poets, arab
african american women novelists;	african american novelists
russian american women;	russian americans
women computer engineers;	computer engineers
women physical anthropologists;	physical anthropologists
women poets, greek;	poets, greek
women authors, spanish american;	authors, spanish american
catholic women artists;	catholic artists
blind women;	blinds
women, haya;	haya (african people)
women historians of technology;	historians of technology
women college presidents;	college presidents
women biographers;	biographers
women country musicians;	country musicians
african american women newspaper editors;	african american newspaper editors
speedball for women;	speedball
women automobile industry workers;	automobile industry workers
minority women librarians;	minority librarians
women, mandingo;	mandingo (african people)
women, lango;	lango (african people)
pomo women weavers;	pomo weavers
mass media and women;	mass media
women authors, turkish;	authors, turkish
women medievalists;	medievalists
women ethnobotanists;	ethnobotanists
women, turkmen;	turkmen
women bookbinders;	bookbinders
women authors, finnish;	authors, finnish
women poets, icelandic;	poets, icelandic
inuit women artists;	inuit artists
young women with disabilities;	young adults with disabilities
women botanists;	botanists
women police chiefs;	police chiefs
shiite women;	shiites
women evangelists;	evangelists
asian american women artists;	asian american artists
hyperphagia in women;	hyperphagia
women's periodicals, bolivian;	bolivian periodicals
older sexual minority women;	older sexual minorities
women capitalists and financiers;	capitalists and financiers
women educators;	educators
women authors, serbian;	authors, serbian
women, kiranti;	kiranti (asian people)
women, hima;	hima (african people)
women college graduates;	college graduates
women authors, galician;	authors, galician
sailing for women;	sailing
women, nama;	nama (african people)
helplessness (psychology) in women;	helplessness (psychology)
women pharmacists;	pharmacists
reformed church women;	reformed church
women vintners;	vintners
women authors, malayalam;	authors, malayalam
women government executives;	government executives
women athletes with disabilities;	athletes with disabilities
women antiheroes in literature;	antiheroes in literature
women theatrical managers;	theatrical managers
women poets, urdu;	poets, urdu
women poets, telugu;	poets, telugu
women novelists, chinese;	novelists, chinese
afghan american women;	afghan americans
african american women tennis players;	african american tennis players
filipino american women artists;	filipino american artists
women otolaryngologists;	otolaryngologists
women, afghan;	afghans
women music critics;	music critics
women libertarians;	libertarians
african american women comedians;	african american comedians
women, adnyamathanha;	adnyamathanha (australian people)
women midwives;	midwives
women authors, panjabi;	authors, panjabi
older women automobile drivers;	older automobile drivers
african american women artists;	african american artists
pueblo women;	pueblos
women television viewers;	television viewers
women community health aides;	community health aides
guatemalan american women;	guatemalan americans
women, bira;	bira (african people)
women punk rock musicians;	punk rock musicians
women's encyclopedias and dictionaries, chinese;	encyclopedias and dictionaries, chinese
women's periodicals, yugoslav;	yugoslav periodicals
women bullfighters;	bullfighters
women prophets;	prophets
women marines;	marines
women, hmong;	hmong (asian people)
women library trustees;	library trustees
women and design;	design
indian women teachers;	indian teachers
métis women artists;	métis artists
women, maratha;	maratha (indic people)
women agricultural extension workers;	agricultural extension workers
women, māori;	māori (new zealand people)
women, serer;	serer (african people)
women, manyika;	manyika (african people)
women authors, south asian;	authors, south asian
women authors, caribbean;	authors, caribbean
women volleyball players;	volleyball players
women city planners;	city planners
women field hockey players;	field hockey players
women authors, pakistani;	authors, pakistani
women art teachers;	art teachers
women's periodicals, brazilian;	brazilian periodicals
women, black, in comics;	black people in comics
women, karen;	karen (southeast asian people)
women, swazi;	swazi (african people)
jewish women photographers;	jewish photographers
women and erotica;	erotica
women art critics;	art critics
buddhist women;	buddhists
women, songhai;	songhai (african people)
dutch american women;	dutch americans
fascism and women;	fascism
jewish women librarians;	jewish librarians
women litigants;	litigants
women authors, commonwealth;	authors, commonwealth
women, daza;	daza (dazaga-speaking people)
women, viking;	vikings
indian women prisoners;	indian prisoners
women sound engineers;	sound engineers
women, grebo;	grebo (african people)
women's periodicals, german;	german periodicals
women, tswana;	tswana (african people)
palestinian american women;	palestinian americans
women air traffic controllers;	air traffic controllers
women's encyclopedias and dictionaries, korean;	encyclopedias and dictionaries, korean
women genealogists;	genealogists
women political activists;	political activists
women molecular biologists;	molecular biologists
women authors, norwegian;	authors, norwegian
women harpsichordists;	harpsichordists
women engravers;	engravers
women teachers, white;	teachers, white
women agricultural engineers;	agricultural engineers
women planners;	planners
women, garo;	garo (indic people)
deafblind women;	deafblind people
nicaraguan american women;	nicaraguan americans
women, medlpa;	medlpa (papua new guinean people)
women triathletes;	triathletes
women cigarette smokers;	cigarette smokers
women, bijago;	bijago (african people)
women, birom;	birom (african people)
women dairy farmers;	dairy farmers
women justices of the peace;	justices of the peace
women brickmakers;	brickmakers
women drummers (musicians);	drummers (musicians)
sleep disorders in women;	sleep disorders
danish american women;	danish americans
lebanese american women;	lebanese americans
women shepherds;	shepherds
social work with minority women;	social work with minorities
radio and women;	radio
women authors, indic;	authors, indic
women dramatists, mexican;	dramatists, mexican
women poets, slovak;	poets, slovak
minority women executives;	minority executives
african american women motion picture producers and directors;	african american motion picture producers and directors
sterilization of women;	sterilization
women poets, english;	poets, english
women poets, finnish;	poets, finnish
women dramatists, spanish;	dramatists, spanish
women, asu;	asu (african people)
women, tairora;	tairora (papua new guinean people)
indian women potters;	indian potters
women occultists;	occultists
women, ngangte;	ngangte (african people)
women cytologists;	cytologists
women personal trainers;	personal trainers
women authors, portuguese;	authors, portuguese
hiking for women;	hiking
women fuelwood gatherers;	fuelwood gatherers
women engineering students;	engineering students
women philologists;	philologists
women pathologists;	pathologists
women psychologists;	psychologists
women authors, malian;	authors, malian
women sculptors;	sculptors
women authors, bengali;	authors, bengali
women soldiers in motion pictures;	soldiers in motion pictures
women prime ministers;	prime ministers
women ex-convicts;	ex-convicts
women socialists;	socialists
african american women lawyers;	african american lawyers
women poets, israeli;	poets, israeli
women assyriologists;	assyriologists
women hop pickers;	hop pickers
italian american women authors;	italian american authors
female gang members;	gang members
women fascists;	fascists
women authors, hausa;	authors, hausa
women, huli;	huli (papua new guinean people)
women poets, spanish american;	poets, spanish american
women tap dancers;	tap dancers
east indian american women;	east indian americans
women, east indian;	east indians
women sufis;	sufis
basque american women;	basque americans
indian women authors;	indian authors
women, minahasa;	minahasa (indonesian people)
women's periodicals, arabic;	arabic periodicals
women poets, kurdish;	poets, kurdish
women chess players;	chess players
women mystics;	mystics
women spiritualists;	spiritualists
women, mende;	mende (african people)
taos women;	tao
women authors, scottish;	authors, scottish
women moneylenders;	moneylenders
women volunteers;	volunteers
women and the decorative arts;	decorative arts
women authors, brazilian;	authors, brazilian
women, bwa;	bwa (african people)
anabaptist women;	anabaptists
women skiers;	skiers
women spies in literature;	spies in literature
baseball for women;	baseball
sexual minority women in literature;	minorities in literature
women parade float designers;	parade float designers
women's periodicals, french-canadian;	french-canadian periodicals
women's periodicals, dutch;	dutch periodicals
achievement motivation in women;	achievement motivation
field hockey for women;	field hockey
women dramatists, american;	dramatists, american
women war correspondents;	war correspondents
women, mbugwe;	mbugwe (african people)
women photographers;	photographers
women coffee plantation workers;	coffee plantation workers
women fakirs;	fakirs
women sports spectators;	sports spectators
women specialists;	specialists
women alternative rock musicians;	alternative rock musicians
minority women;	minorities
women historians;	historians
women attorneys general;	attorneys general
women novelists, irish;	novelists, irish
eskimo women;	eskimos
women soldiers in mass media;	soldiers in mass media
women pioneers;	pioneers
women prophets in art;	prophets in art
women, saramacca;	saramacca (surinamese people)
women agricultural economists;	agricultural economists
women poets, filipino;	poets, filipino
women, mpongwe;	mpongwe (african people)
cycling for women;	cycling
iranian american women;	iranian americans
women, khoikhoi;	khoikhoi (african people)
women musicians in literature;	musicians in literature
african american women entertainers;	african american entertainers
filipino american women college students;	filipino american college students
women migrant labor;	migrant labor
women, lyela;	lyela (african people)
women environmentalists;	environmentalists
women authors, zimbabwean;	authors, zimbabwean
women film critics;	film critics
women hikers;	hikers
multiracial women;	multiracial people
women ranchers;	ranchers
women plantation workers;	plantation workers
female honeybees;	honeybee
resilience (personality trait) in women;	resilience (personality trait)
women authors, uruguayan;	authors, uruguayan
women oceanographers;	oceanographers
women dentists;	dentists
women church officers;	church officers
break dancing for women;	break dancing
women, sahrawi;	sahrawi (african people)
women sports executives;	sports executives
church work with female juvenile delinquents;	church work with juvenile delinquents
women law students;	law students
women poets, turkish;	poets, turkish
women authors, colombian;	authors, colombian
women child molesters;	child molesters
inupiat women;	inupiat
mexican american women authors;	mexican american authors
women, sambia;	sambia (papua new guinean people)
women labor leaders;	labor leaders
women authors, filipino;	authors, filipino
women's periodicals, faroese;	faroese periodicals
women school supervisors;	school supervisors
women authors, tamil;	authors, tamil
women nazi concentration camp inmates;	nazi concentration camp inmates
women cartoonists;	cartoonists
women, gogo;	gogo (african people)
women museum curators;	museum curators
weight training for women;	weight training
women supervisors;	supervisors
sexual ethics for women;	sexual ethics
women opera producers and directors;	opera producers and directors
women musicians in art;	musicians in art
autistic women;	autistic people
flag football for women;	flag football
television and women;	television
women lighthouse keepers;	lighthouse keepers
women authors, venezuelan;	authors, venezuelan
women poets, bolivian;	poets, bolivian
women cyclists;	cyclists
women flamenco musicians;	flamenco musicians
women farmers;	farmers
women, buriat;	buriats
women, bobo;	bobo (african people)
women criminal justice personnel;	criminal justice personnel
indian women physicians;	indian physicians
women, muria;	muria (indic people)
women biblical scholars;	biblical scholars
women, siddi;	siddi (indic people)
women authors, armenian;	authors, armenian
garifuna women;	garifuna (caribbean people)
african american women evangelists;	african american evangelists
women telegraphers;	telegraphers
women information scientists;	information scientists
women authors, urdu;	authors, urdu
african american women choreographers;	african american choreographers
women drag racers;	drag racers
women authors, indonesian;	authors, indonesian
sikh women;	sikhs
women, fula;	fula (african people)
women, okiek;	okiek (african people)
women's periodicals, danish;	danish periodicals
women poets, mexican;	poets, mexican
women fishery scientists;	fishery scientists
women sound recording executives and producers;	sound recording executives and producers
women, burmese;	burmese
women jewelers;	jewelers
women novelists, spanish;	novelists, spanish
women authors, cuban;	authors, cuban
women authors, vietnamese;	authors, vietnamese
women tattoo artists;	tattoo artists
women, somali;	somalis
women patients;	patients
korean american women journalists;	korean american journalists
women, hamar;	hamar (african people)
women librarians;	librarians
african american women school administrators;	african american school administrators
women, asmat;	asmat (indonesian people)
women biochemists;	biochemists
women noncitizens;	noncitizens
women religious leaders;	religious leaders
women classicists;	classicists
unitarian women;	unitarians
women ecologists;	ecologists
women's bands (music);	bands (music)
women middle managers;	middle managers
women gynecologists;	gynecologists
women authors, peruvian;	authors, peruvian
women and christian union;	christian union
women animal specialists;	animal specialists
exiled women authors;	authors, exiled
women-owned business enterprises;	business enterprises
women authors, lithuanian;	authors, lithuanian
women drummers (musicians) in art;	drummers (musicians) in art
women and war in literature;	war in literature
women poker players;	poker players
women cannery workers;	cannery workers
women book collectors;	book collectors
egyptian american women;	egyptian americans
women track and field athletes;	track and field athletes
jewish women authors;	jewish authors
women mountaineers;	mountaineers
women carpenters;	carpenters
women's periodicals, african;	african periodicals
women authors, bulgarian;	authors, bulgarian
african american women school superintendents;	african american school superintendents
women tennis players;	tennis players
women poets, australian;	poets, australian
women, mawri;	mawri (african people)
women anarchists;	anarchists
women, buhid;	buhid (philippine people)
women iron and steel workers;	iron and steel workers
aleut women;	aleuts
women bowlers;	bowlers
indian women air pilots;	indian air pilots
women suicide bombers;	suicide bombers
african american women pioneers;	african american pioneers
quaker women;	quakers
hispanic american women college teachers;	hispanic american college teachers
women disaster victims;	disaster victims
female sex offenders;	sex offenders
women poets, puerto rican;	poets, puerto rican
african american women librarians;	african american librarians
women industrial engineers;	industrial engineers
women ethnologists;	ethnologists
crow women;	crows
women deans (education);	deans (education)
women, sgaw karen;	sgaw karen (southeast asian people)
women soccer fans;	soccer fans
women philosophers;	philosophers
cambodian american women;	cambodian americans
women bounty hunters;	bounty hunters
women authors, czech;	authors, czech
female monsters in comics;	monsters in comics
women, minangkabau;	minangkabau (indonesian people)
women authors, estonian;	authors, estonian
women astronauts;	astronauts
women agricultural students;	agricultural students
minority women teachers;	minority teachers
women authors, gujarati;	authors, gujarati
women muralists;	muralists
women test pilots;	test pilots
women saints;	saints
women authors, canadian;	authors, canadian
women, gambaye;	gambaye (african people)
women, anglo-indian, in literature;	indians in literature
women poets, haitian;	poets, haitian
yuit eskimo women;	yuit eskimos
women authors, flemish;	authors, flemish
women lawyers in motion pictures;	lawyers in motion pictures
women astronomers;	astronomers
sports for women;	sports
women terrorists;	terrorists
women's periodicals, thai;	thai periodicals
women potters;	potters
women, ukrainian;	ukrainians
women superheroes;	superheroes
women authors, persian;	authors, persian
finnish american women;	finnish americans
women bodybuilders;	bodybuilders
buddhist monasticism and religious orders for women;	buddhist monasticism and religious orders
women poets, czech;	poets, czech
women authors, austrian;	authors, austrian
women legislators;	legislators
women poets in literature;	poets in literature
women zoologists;	zoologists
women health reformers;	health reformers
women, aboriginal australian;	aboriginal australians
women's periodicals, english;	english periodicals
women novelists, american;	novelists, american
women's police stations;	police stations
women's music festivals;	music festivals
quaker women missionaries;	quaker missionaries
women soldiers;	soldiers
women poets, japanese;	poets, japanese
women history teachers;	history teachers
women city council members;	city council members
women horticultural writers;	horticultural writers
african american women surgeons;	african american surgeons
african american women critics;	african american critics
women roller skaters;	roller skaters
women, cypriot;	cypriots
minority women in motion pictures;	minorities in motion pictures
muslim women superheroes in comics;	muslim superheroes in comics
women rodeo performers;	rodeo performers
women's periodicals, turkish;	turkish periodicals
women lace makers;	lace makers
women arabists;	arabists
women freethinkers;	freethinkers
women social scientists;	social scientists
filipino american women authors;	filipino american authors
women earth scientists;	earth scientists
women, dorze;	dorze (african people)
women, tanala;	tanala (malagasy people)
women authors, croatian;	authors, croatian
women's television programs;	television programs
women radio producers and directors;	radio producers and directors
women sociology students;	sociology students
women, pitjantjatjara;	pitjantjatjara (australian people)
women baseball fans;	baseball fans
southeast asian american women;	southeast asian americans
women civil rights workers;	civil rights workers
women entertainers;	entertainers
women theater critics;	theater critics
women primatologists;	primatologists
minority women in the professions;	minorities in the professions
women salt workers;	salt workers
women novelists, australian;	novelists, australian
women horse owners;	horse owners
women marine scientists;	marine scientists
women indianists;	indianists
women theologians;	theologians
women anti-apartheid activists;	anti-apartheid activists
moravian women;	moravians
african american women screenwriters;	african american screenwriters
female assassins;	assassins
women dramatists, greek (modern);	dramatists, greek (modern)
women surfers;	surfers
women, builsa;	builsa (african people)
women pediatricians;	pediatricians
women accordionists;	accordionists
women poets, austrian;	poets, austrian
women death row inmates;	death row inmates
women, harari;	harari (african people)
women dressmakers;	dressmakers
women, cook islander;	cook islanders
bodybuilding for women;	bodybuilding
women clergy;	clergy
women sprinters;	sprinters
women tramps;	tramps
music by african american women composers;	music by african american composers
south asian american women;	south asian americans
women authors, slovenian;	authors, slovenian
women fencers;	fencers
sedentary women;	sedentary people
women novelists, german;	novelists, german
women printers;	printers
women, rodiya;	rodiya (sri lankan people)
inuit women;	inuit
women flute players in art;	flute players in art
women novelists, canadian;	novelists, canadian
in-line skating for women;	in-line skating
women computer scientists;	computer scientists
women physicists;	physicists
women science students;	science students
mennonite women;	mennonites
women carcinologists;	carcinologists
women medalists;	medalists
judo for women;	judo
women novelists, new zealand;	novelists, new zealand
women, bobo dioula;	bobo dioula (african people)
zoroastrian women;	zoroastrians
cuban american women television personalities;	cuban american television personalities
women asianists;	asianists
women saints in literature;	saints in literature
african american women rock musicians;	african american rock musicians
women, walmajarri;	walmajarri (australian people)
mentally ill women;	mentally ill
women saints in art;	saints in art
women serial murderers;	serial murderers
women figure skaters;	figure skaters
women translators;	translators
women fire lookouts;	fire lookouts
women healers;	healers
women, baruya;	baruya (papua new guinean people)
women marine mammalogists;	marine mammalogists
women governors;	governors
women broadcasters;	broadcasters
women, yuin;	yuin (australian people)
hispanic american women authors;	hispanic american authors
women agriculturists;	agriculturists
jewish women philanthropists;	jewish philanthropists
women storytellers;	storytellers
women glassworkers;	glassworkers
women dermatologists;	dermatologists
women's periodicals, australian;	australian periodicals
women poets, uruguayan;	poets, uruguayan
women athletic trainers;	athletic trainers
women, wiru;	wiru (papua new guinean people)
women clerks (retail trade);	clerks (retail trade)
women polo players;	polo players
women archaeologists;	archaeologists
women critics;	critics
women poets, ukrainian;	poets, ukrainian
women, senufo;	senufo (african people)
african american women basketball players;	african american basketball players
women, logooli;	logooli (african people)
women foreign workers;	foreign workers
women's restrooms;	restrooms
women authors, bolivian;	authors, bolivian
women novelists, swedish;	novelists, swedish
women nazis;	nazis
women travelers;	travelers
women library administrators;	library administrators
women with disabilities in literature;	people with disabilities in literature
women illustrators;	illustrators
women cigar makers;	cigar makers
women and death;	death
women authors, west indian;	authors, west indian
women cabinet officers;	cabinet officers
african american women scholars;	african american scholars
indian women astronauts;	indian astronauts
women's periodicals, polish;	polish periodicals
women medical technologists;	medical technologists
women air pilots;	air pilots
women forensic anthropologists;	forensic anthropologists
women authors, nigerian;	authors, nigerian
african american women healers;	african american healers
women jurors;	jurors
women prisoners in art;	prisoners in art
women poets, tamil;	poets, tamil
women missionaries;	missionaries
women sailors;	sailors
women botanizers;	botanizers
muslim women in art;	muslims in art
women, danube swabian;	danube swabians
women football players;	football players
women conductors (music);	conductors (music)
women veterinary students;	veterinary students
women, dagaaba;	dagaaba (african people)
women prisoners in literature;	prisoners in literature
women, sumi naga;	sumi naga (indic people)
women dramatists, australian;	dramatists, australian
women heroes in literature;	heroes in literature
minority women in literature;	minorities in literature
african american women public relations personnel;	african american public relations personnel
latter day saint women missionaries;	latter day saint missionaries
hockey for women;	hockey
women, madurese;	madurese (indonesian people)
women political candidates;	political candidates
women independent filmmakers;	independent filmmakers
women consultants;	consultants
indian women college students;	indian college students
nahua women;	nahuas
women jewish scholars;	jewish scholars
women authors, chinese;	authors, chinese
mixtec women weavers;	mixtec weavers
women copy writers;	copy writers
methodist women;	methodists
african american women household employees;	african american household employees
women art dealers;	art dealers
women sportscasters;	sportscasters
asian american women in literature;	americans in literature
female monsters;	monsters
women authors, argentine;	authors, argentine
women novelists, catalan;	novelists, catalan
women novelists, norwegian;	novelists, norwegian
women gladiators;	gladiators
women professional employees;	professional employees
self-employed women;	self-employed
women cat owners;	cat owners
women, baka;	baka (west african people)
women, meo;	meo (indic people)
women, pedi;	pedi (african people)
women's periodicals, canadian;	canadian periodicals
women poets, belarusian;	poets, belarusian
women, lao;	lao (tai people)
women dramatists, argentine;	dramatists, argentine
indian women sculptors;	indian sculptors
indian women veterans;	indian veterans
jewish women cartoonists;	jewish cartoonists
successful women;	successful people
women, lambadi;	lambadi (indic people)
women intellectuals;	intellectuals
women authors, greek;	authors, greek
women baseball team owners;	baseball team owners
church work with older women;	church work with older people
women pacifists;	pacifists
african american women athletes;	african american athletes
women intellectuals in literature;	intellectuals in literature
women private investigators;	private investigators
women guerrillas;	guerrillas
women drug dealers;	drug dealers
women skaters;	skaters
hispanic american women artists;	hispanic american artists
women jockeys;	jockeys
women presidents on television;	presidents on television
african american women abolitionists;	african american abolitionists
women automobile racing drivers;	automobile racing drivers
spiritual retreats for women;	spiritual retreats
women, rajput;	rajput (indic people)
women labor union members;	labor union members
mexican american women in literature;	americans in literature
women, kgatla;	kgatla (african people)
women authors, south african;	authors, south african
swimming for women;	swimming
women authors, kannada;	authors, kannada
women basketball coaches;	basketball coaches
nahua women weavers;	nahua weavers
women ambulance drivers;	ambulance drivers
women pirates;	pirates
women college teachers;	college teachers
women cardiologists;	cardiologists
women authors, marathi;	authors, marathi
hindu women saints;	hindu saints
women, chwabo;	chwabo (african people)
women, hakka;	hakka (chinese people)
women novelists;	novelists
women, banyjima;	banyjima (australian people)
women, tetum;	tetum (indonesian people)
women's computer network resources;	computer network resources
women, balanta;	balanta (african people)
female middle school athletes;	middle school athletes
poker for women;	poker
women baseball players;	baseball players
children of women drug addicts;	children of drug addicts
libraries and women;	libraries
leadership in women;	leadership
women poets, canadian;	poets, canadian
women area specialists;	area specialists
sea kayaking for women;	sea kayaking
women, ashanti;	ashanti (african people)
women paleontologists;	paleontologists
ski jumping for women;	ski jumping
women, manga;	manga (nigerien and nigerian people)
women, gouin;	gouin (african people)
women poets, romanian;	poets, romanian
women gymnasts;	gymnasts
women lithographers;	lithographers
women authors, palestinian arab;	authors, palestinian arab
buddhist women in art;	buddhists in art
women coaches (athletics);	coaches (athletics)
women poets, spanish;	poets, spanish
catholic women authors;	catholic authors
older women authors;	older authors
women daredevils;	daredevils
women, turkana;	turkana (african people)
women blues musicians;	blues musicians
women rabbis;	rabbis
women rubber industry workers;	rubber industry workers
chronic pain in women;	chronic pain
women automobile drivers;	automobile drivers
women ethologists;	ethologists
multiracial women in literature;	multiracial people in literature
stress management for women;	stress management
women detectives in literature;	detectives in literature
african american women college teachers;	african american college teachers
women alcoholics;	alcoholics
women authors, kurdish;	authors, kurdish
women physicians;	physicians
women physical therapists;	physical therapists
women-owned architectural firms;	architectural firms
track and field for women;	track and field
brahman women;	brahman
women community college presidents;	community college presidents
women's bookplates;	bookplates
portuguese american women;	portuguese americans
women sadhus;	sadhus
women seminarians;	seminarians
women brewery workers;	brewery workers
women authors, malay;	authors, malay
mexican american women artists;	mexican american artists
women wrestlers;	wrestlers
women social workers, black;	social workers, black
women aquatic scientists;	aquatic scientists
women stringed instrument players in art;	stringed instrument players in art
women peasants;	peasants
women military cadets;	military cadets
african american women air pilots;	african american air pilots
women authors, belgian;	authors, belgian
women leather workers;	leather workers
women surveyors;	surveyors
women football coaches;	football coaches
post-traumatic stress disorder in women;	post-traumatic stress disorder
women break dancers;	break dancers
women, palestinian arab;	palestinian arabs
women election officials;	election officials
women, white, in art;	white people in art
women poets, hungarian;	poets, hungarian
women olympic athletes;	olympic athletes
women poets, azerbaijani;	poets, azerbaijani
sudanese american women;	sudanese americans
women, bilen;	bilen (african people)
african american women civic leaders;	african american civic leaders
women martial artists;	martial artists
reformatories for women;	reformatories
women commercial artists;	commercial artists
tumors in women;	tumors
female juvenile delinquents in literature;	juvenile delinquents in literature
adult education of women;	adult education
women aquatic biologists;	aquatic biologists
women authors, sri lankan;	authors, sri lankan
women authors, swiss;	authors, swiss
women, tigrinya;	tigrinya (african people)
women wood-pulp industry workers;	wood-pulp industry workers
women graduate students;	graduate students
women metal-workers;	metal-workers
women netball players;	netball players
women, igbo;	igbo (african people)
taoist women;	taoists
women novelists, english;	novelists, english
women and socialism;	socialism
mexican american women;	mexican americans
puerto rican women;	puerto ricans
women executives;	executives
women authors in literature;	authors in literature
women gardeners;	gardeners
women authors, danish;	authors, danish
hispanic american women civic leaders;	hispanic american civic leaders
women softball players;	softball players
women-owned engineering firms;	engineering firms
women newspaper editors;	newspaper editors
women musicologists;	musicologists
women alternative country musicians;	alternative country musicians
women, tiv;	tiv (african people)
women poets, indonesian;	poets, indonesian
women geographers;	geographers
women dramatists, canadian;	dramatists, canadian
vietnamese american women;	vietnamese americans
asian american women college teachers;	asian american college teachers
women conscientious objectors;	conscientious objectors
women landscape architects;	landscape architects
women's music;	music
women, enga;	enga (papua new guinean people)
women, bini;	bini (african people)
fox women;	foxes
women superheroes in mass media;	superheroes in mass media
women, orang asli;	orang asli (malaysian people)
women clothing workers;	clothing workers
women's periodicals, spanish;	spanish periodicals
women service industries workers;	service industries workers
women food service employees;	food service employees
women authors, singaporean;	authors, singaporean
women beekeepers;	beekeepers
women textile workers;	textile workers
jewish women artists;	jewish artists
women, jaintia;	jaintia (indic people)
episcopalian women;	episcopalians
women painters;	painters
women church historians;	church historians
women slaveholders;	slaveholders
african american women pacifists;	african american pacifists
women artists, black;	artists, black
women dancers in art;	dancers in art
women, lisu;	lisu (southeast asian people)
occupational training for women;	occupational training
women artisans;	artisans
women motorcyclists;	motorcyclists
women plantation owners;	plantation owners
women heads of households;	heads of households
women and philology;	philology
women intelligence officers;	intelligence officers
women band directors;	band directors
women authors, sierra leonean;	authors, sierra leonean
hispanic american women college students;	hispanic american college students
women poets, german;	poets, german
women prisoners of war;	prisoners of war
women superheroes in literature;	superheroes in literature
women's periodicals, russian;	russian periodicals
mexican american women college teachers;	mexican american college teachers
women soldiers on television;	soldiers on television
women, nubian;	nubians
minority women artists;	minority artists
women musical theater producers and directors;	musical theater producers and directors
women's periodicals, southern european;	southern european periodicals
african american women chemists;	african american chemists
alaska native women;	alaska natives
women ski jumpers;	ski jumpers
dominican american women;	dominican americans
women authors, ugandan;	authors, ugandan
women engineers;	engineers
women, kipsigis;	kipsigis (african people)
women authors, hindi;	authors, hindi
women poets, russian;	poets, russian
women authors, icelandic;	authors, icelandic
women's periodicals, irish;	irish periodicals
women printmakers;	printmakers
women, shandar;	shandar (bangladeshi people)
women motion picture editors;	motion picture editors
women and communism;	communism
women, meithei;	meithei (south asian people)
women, bhil;	bhil (indic people)
women, pushtun;	pushtuns
women skateboarders;	skateboarders
outdoor recreation for women;	outdoor recreation
women, batwa;	batwa (african people)
women basket makers;	basket makers
women's periodicals, mexican;	mexican periodicals
tzeltal women weavers;	tzeltal weavers
boxing for women;	boxing
women, samoan;	samoans
women's exchanges;	exchange
cuban american women;	cuban americans
women school principals;	school principals
women, iraqw;	iraqw (african people)
swedenborgian women;	swedenborgians
women's prayer groups;	prayer groups
women sexologists;	sexologists
autoimmune diseases in women;	autoimmune diseases
mexican american women agricultural laborers;	mexican american agricultural laborers
bengali american women;	bengali americans
women circus performers;	circus performers
women architects;	architects
women, narrinyeri;	narrinyeri (australian people)
women lyricists;	lyricists
women type designers;	type designers
women cantors (judaism);	cantors (judaism)
women, dinka;	dinka (african people)
women historians of science;	historians of science
women dramatists, english;	dramatists, english
african american women legislators;	african american legislators
women forensic scientists;	forensic scientists
women electronic data processing personnel;	electronic data processing personnel
women international relations specialists;	international relations specialists
hispanic american women healers;	hispanic american healers
volleyball for women;	volleyball
minority women in higher education;	minorities in higher education
women jewel thieves;	jewel thieves
women accountants;	accountants
women journalists in motion pictures;	journalists in motion pictures
women insurance executives;	insurance executives
cricket for women;	cricket
women, black, in popular culture;	black people in popular culture
women novelists, french;	novelists, french
chinese american women;	chinese americans
women poets, gujarati;	poets, gujarati
japanese american women soldiers;	japanese american soldiers
women imams (mosque officers);	imams (mosque officers)
women authors, slovak;	authors, slovak
hispanic american women legislators;	hispanic american legislators
women wood-engravers;	wood-engravers
women civic leaders;	civic leaders
women artists, aboriginal australian;	artists, aboriginal australian
women authors, egyptian;	authors, egyptian
christian women saints in art;	christian saints in art
hypertension in women;	hypertension
women aerospace engineers;	aerospace engineers
monastic and religious life of women;	monastic and religious life
women's periodicals, hindi;	hindi periodicals
internet and women;	internet
women politicians;	politicians
women torturers;	torturers
women dental students;	dental students
women fashion designers;	fashion designers
african american women dancers;	african american dancers
african american women civil rights workers;	african american civil rights workers
women pianists;	pianists
women geophysicists;	geophysicists
computers and women;	computers
indian women in art;	indians in art
women, baule;	baule (african people)
women entomologists;	entomologists
women costume designers;	costume designers
women museum directors;	museum directors
women authors, israeli;	authors, israeli
jewish women college teachers;	jewish college teachers
women humorists;	humorists
women and freemasonry;	freemasonry
women immigrants in motion pictures;	immigrants in motion pictures
women correctional personnel;	correctional personnel
women poets, swedish;	poets, swedish
women, wolof;	wolof (african people)
women, tamang;	tamang (nepalese people)
women transplant surgeons;	transplant surgeons
women fiddlers;	fiddlers
women television producers and directors;	television producers and directors
women poets, chinese;	poets, chinese
women glass artists;	glass artists
lacrosse for women;	lacrosse
women, yoruba;	yoruba (african people)
women music patrons;	music patrons
women, saharia;	saharia (indic people)
diabetes in women;	diabetes
women popular music fans;	popular music fans
african american women college administrators;	african american college administrators
women authors, hungarian;	authors, hungarian
hindu women in literature;	hindus in literature
women's encyclopedias and dictionaries, japanese;	encyclopedias and dictionaries, japanese
women stockbrokers;	stockbrokers
women pipe fitters;	pipe fitters
women poets, honduran;	poets, honduran
minority women college administrators;	minority college administrators
women, bariba;	bariba (african people)
women, kucabandiyā;	kucabandiyā (indic people)
women, lushai;	lushai (asian people)
married women in literature;	married people in literature
women, hamtai;	hamtai (papua new guinean people)
women, dorobo;	dorobo (african people)
women authors, costa rican;	authors, costa rican
women speechwriters;	speechwriters
women, nyaturu;	nyaturu (african people)
women heroes;	heroes
women, minianka;	minianka (african people)
asian american women authors;	asian american authors
african american women composers;	african american composers
women gold miners;	gold miners
women and city planning;	city planning
women authors, panamanian;	authors, panamanian
african american women law teachers;	african american law teachers
women healers in literature;	healers in literature
women diplomats;	diplomats
mexican american women labor union members;	mexican american labor union members
chinese american women in literature;	americans in literature
women public relations personnel;	public relations personnel
women television writers;	television writers
women, gallong;	gallong (indic people)
women chief executive officers;	chief executive officers
women ichthyologists;	ichthyologists
video games for women;	video games
african american women judges;	african american judges
women colonists;	colonists
women rowers;	rowers
women divers;	divers
women landowners;	landowners
indian women photographers;	indian photographers
women coal miners;	coal miners
women speed skaters;	speed skaters
women college teachers in literature;	college teachers in literature
african american women physicists;	african american physicists
women refugees;	refugees
lutheran women;	lutherans
women nobel prize winners;	nobel prize winners
women, karamojong;	karamojong (african people)
women school superintendents;	school superintendents
women agricultural laborers;	agricultural laborers
women shamans;	shamans
women hymn writers;	hymn writers
women generals;	generals
women, dayak;	dayak (bornean people)
women clerks;	clerks
women, arab;	arabs
chilean american women;	chilean americans
older mexican american women;	older mexican americans
women antiheroes on television;	antiheroes on television
women drywall contractors;	drywall contractors
self-actualization (psychology) in women;	self-actualization (psychology)
african american women dramatists;	african american dramatists
women, gimi;	gimi (papua new guinean people)
aleut women basket makers;	aleut basket makers
african american women political activists;	african american political activists
pacific islander american women;	pacific islander americans
women motion picture producers and directors;	motion picture producers and directors
women authors, chilean;	authors, chilean
indian women in literature;	indians in literature
women authors, assamese;	authors, assamese
women amusement park owners;	amusement park owners
women, zaramo;	zaramo (african people)
women computer programmers;	computer programmers
women, zulu;	zulu (african people)
women's periodicals, finnish;	finnish periodicals
women muslim scholars;	muslim scholars
women tea plantation workers;	tea plantation workers
dance for women;	dance
french-canadian women;	french-canadians
women television personalities;	television personalities
women, ganda;	ganda (african people)
women's periodicals, catalan;	catalan periodicals
women, bidayuh;	bidayuh (bornean people)
women political prisoners;	political prisoners
women spiritual directors;	spiritual directors
women teachers, black;	teachers, black
women, kela;	kela (african people)
women poets, nicaraguan;	poets, nicaraguan
women archaeology teachers;	archaeology teachers
women fantasy gamers;	fantasy gamers
hispanic american women television personalities;	hispanic american television personalities
basketball for women;	basketball
women bacteriologists;	bacteriologists
women insurance agents;	insurance agents
women poets, chilean;	poets, chilean
women performance artists;	performance artists
women, berber;	berbers
women's shoes;	shoes
women war criminals;	war criminals
black seminole women;	black seminoles
latter day saint women authors;	latter day saint authors
women-owned landscape architectural firms;	landscape architectural firms
women, gamo;	gamo (african people)
women poets, irish;	poets, irish
women cinematographers;	cinematographers
women poets, basque;	poets, basque
women with social disabilities;	people with social disabilities
women, chewa;	chewa (african people)
women art historians;	art historians
women authors, telugu;	authors, telugu
women bankers;	bankers
developmentally disabled women;	developmentally disabled
women authors, algerian;	authors, algerian
women, bafokeng;	bafokeng (african people)
african american women social reformers;	african american social reformers
women and psychoanalysis;	psychoanalysis
women authors, nepali;	authors, nepali
african american women television journalists;	african american television journalists
women dramatists, irish;	dramatists, irish
women basketball players;	basketball players
women theatrical producers and directors;	theatrical producers and directors
women's periodicals, new zealand;	new zealand periodicals
jewish women physicians;	jewish physicians
women geologists;	geologists
women colonial administrators;	colonial administrators
minority women college teachers;	minority college teachers
women, raj gond;	raj gond (indic people)
women's periodicals, american;	american periodicals
muslim women authors;	muslim authors
indian women jewelers;	indian jewelers
women, berawan;	berawan (malaysian people)
hawaiian women;	hawaiians
women rap musicians;	rap musicians
women dog owners;	dog owners
jewish women comedians;	jewish comedians
women, kamilaroi;	kamilaroi (australian people)
professional education of women;	professional education
women revolutionaries;	revolutionaries
women, uighur;	uighur (turkic people)
women apprentices;	apprentices
muslim women in literature;	muslims in literature
women, nisi;	nisi (indic people)
women snowboarders;	snowboarders
hawaiian women in art;	hawaiians in art
women, ifugao;	ifugao (philippine people)
women, !kung;	!kung (african people)
women, mafa;	mafa (african people)
women economics historians;	economics historians
women radio writers;	radio writers
women's periodicals, austrian;	austrian periodicals
women dramatists, persian;	dramatists, persian
women poets, vietnamese;	poets, vietnamese
golf for women;	golf
female gangs;	gangs
women mayors;	mayors
argentine american women;	argentine americans
women medical students;	medical students
women conservationists;	conservationists
women bank employees;	bank employees
women sportswriters;	sportswriters
women rice workers;	rice workers
women, magar;	magar (nepalese people)
women school administrators;	school administrators
women genocide survivors;	genocide survivors
women, torres strait islander;	torres strait islanders
women authors, turkmen;	authors, turkmen
women nazi concentration camp guards;	nazi concentration camp guards
minority women college graduates;	minority college graduates
women's periodicals, japanese;	japanese periodicals
women medical historians;	medical historians
women analysands;	analysands
women, gisiga;	gisiga (african people)
women authors, black;	authors, black
women authors, mexican;	authors, mexican
women exhibitors;	exhibitors
women silversmiths;	silversmiths
indian women dancers;	indian dancers
indian women poets;	indian poets
african american women politicians;	african american politicians
women regents;	regents
women, rendille;	rendille (african people)
women christian educators;	christian educators
women amusement ride owners;	amusement ride owners
women presidential candidates;	presidential candidates
women physical education teachers;	physical education teachers
women, bamileke;	bamileke (african people)
creative ability in women;	creative ability
women, chakma;	chakma (asian people)
women cartographers;	cartographers
women benefactors;	benefactors
separated women;	separated people
women, black, in art;	black people in art
african american women golfers;	african american golfers
women drug addicts;	drug addicts
jewish religious education of women;	jewish religious education
indian women in motion pictures;	indians in motion pictures
women authors, scandinavian;	authors, scandinavian
women authors, dominican;	authors, dominican
women dramatists, arab;	dramatists, arab
indian women artists;	indian artists
women miners;	miners
women bass guitarists;	bass guitarists
women bookplate designers;	bookplate designers
soccer for women;	soccer
women political consultants;	political consultants
inca women;	incas
women artists in literature;	artists in literature
women's periodicals, persian;	persian periodicals
women circus performers in literature;	circus performers in literature
assyrian women;	assyrians
women, lebou;	lebou (african people)
african american women school principals;	african american school principals
women team handball players;	team handball players
women veterinarians;	veterinarians
jamaican american women;	jamaican americans
carrier women;	carriers
children of women prisoners;	children of prisoners
women physician executives;	physician executives
fly fishing for women;	fly fishing
women, sami;	sami (european people)
women authors, yiddish;	authors, yiddish
women bishops;	bishops
women, bambara;	bambara (african people)
women, kwena;	kwena (african people)
women guitarists;	guitarists
women orienteers;	orienteers
women anthropologists;	anthropologists
women's periodicals, swedish;	swedish periodicals
muslim women saints;	muslim saints
women, anglo-indian;	anglo-indians
jewish women basketball players;	jewish basketball players
women computational neuroscientists;	computational neuroscientists
greek american women;	greek americans
women, hausa;	hausa (african people)
women communists;	communists
women, tarok;	tarok (african people)
karaite women;	karaites
hispanic american women in literature;	americans in literature
women's periodicals, chinese;	chinese periodicals
women library employees;	library employees
women goldsmiths;	goldsmiths
women hermits;	hermits
muslim women in motion pictures;	muslims in motion pictures
